ga	が
gi	ぎ
gu	ぐ
ge	げ
go	ご
g'	がい
g,	ごう
g.	げい
gp	ぐう
g;	がん
gq	ごん
gj	げん
gk	ぐん
gx	ぎん

gya	ぎゃ
gyi	ぎぃ
gyu	ぎゅ
gye	ぎぇ
gyo	ぎょ
gy'	ぎゃい
gy,	ぎょう
gy.	ぎぇい
gyp	ぎゅう
gy;	ぎゃん
gyq	ぎょん
gyj	ぎぇん
gyk	ぎゅん
gyx	ぎぃん

gna	ぎゃ
gni	ぎぃ
gnu	ぎゅ
gne	ぎぇ
gno	ぎょ
gn'	ぎゃい
gn,	ぎょう
gn.	ぎぇい
gnp	ぎゅう
gn;	ぎゃん
gnq	ぎょん
gnj	ぎぇん
gnk	ぎゅん
gnx	ぎぃん

gwa	ぐぁ
gwi	ぐぃ
gwu	ぐぅ
gwe	ぐぇ
gwo	ぐぉ
gw'	ぐぁい
gw,	ぐぉう
gw.	ぐぇい
gwp	ぐぅう
gw;	ぐぁん
gwq	ぐぉん
gwj	ぐぇん
gwk	ぐぅん
gwx	ぐぃん