ha	は
hi	ひ
hu	ふ
he	へ
ho	ほ
h'	はい
h,	ほう
h.	へい
hp	ふう
h;	はん
hq	ほん
hj	へん
hk	ふん
hx	ひん

hya	ひゃ
hyi	ひぃ
hyu	ひゅ
hye	ひぇ
hyo	ひょ
hy'	ひゃい
hy,	ひょう
hy.	ひぇい
hyp	ひゅう
hy;	ひゃん
hyq	ひょん
hyj	ひぇん
hyk	ひゅん
hyx	ひぃん

hna	ひゃ
hni	ひぃ
hnu	ひゅ
hne	ひぇ
hno	ひょ
hn'	ひゃい
hn,	ひょう
hn.	ひぇい
hnp	ひゅう
hn;	ひゃん
hnq	ひょん
hnj	ひぇん
hnk	ひゅん
hnx	ひぃん

hwa	ふぁ
hwi	ふぃ
hwe	ふぇ
hwo	ふぉ
hw'	ふぁい
hw,	ふぉう
hw.	ふぇい
hw;	ふぁん
hwq	ふぉん
hwj	ふぇん
hwk	ふん
hwx	ふぃん