ka	か
ki	き
ku	く
ke	け
ko	こ
k'	かい
k,	こう
k.	けい
kp	くう
k;	かん
kq	こん
kj	けん
# kk
kx	きん

kya	きゃ
kyi	きぃ
kyu	きゅ
kye	きぇ
kyo	きょ
ky'	きゃい
ky,	きょう
ky.	きぇい
kyp	きゅう
ky;	きゃん
kyq	きょん
kyj	きぇん
kyk	きゅん
kyx	きぃん

kha	きゃ
khi	きぃ
khu	きゅ
khe	きぇ
kho	きょ
kh'	きゃい
kh,	きょう
kh.	きぇい
khp	きゅう
kh;	きゃん
khq	きょん
khj	きぇん
khk	きゅん
khx	きぃん

kwa	くぁ
kwi	くぃ
kwu	くぅ
kwe	くぇ
kwo	くぉ
kw'	くぁい
kw,	くぉう
kw.	くぇい
kwp	くぅう
kw;	くぁん
kwq	くぉん
kwj	くぇん
kwk	くぅん
kwx	くぃん