ln	ん

la	ぁ
li	ぃ
lu	ぅ
le	ぇ
lo	ぉ
l'	ぁい
l,	ぉう
l.	ぇい
lp	ぅう
l;	ぁん
lq	ぉん
lj	ぇん
lk	ぅん
lx	ぃん

lka	ヵ
lke	ヶ

lca	ヵ
lce	ヶ

ltu	っ
ltsu	っ

lya	ゃ
lyi	ぃ
lyu	ゅ
lye	ぇ
lyo	ょ
ly'	ゃい
ly,	ょう
ly.	ぇう
lyp	ょう
ly;	ゃん
lyq	ょん
lyj	ぇん
lyk	ゅん
lyx	ぃん

lha	ゃ
lhi	ぃ
lhu	ゅ
lhe	ぇ
lho	ょ
lh'	ゃい
lh,	ょう
lh.	ぇう
lhp	ょう
lh;	ゃん
lhq	ょん
lhj	ぇん
lhk	ゅん
lhx	ぃん

lwa	ゎ