xn	ん

xa	ぁ
xi	ぃ
xu	ぅ
xe	ぇ
xo	ぉ
x'	ぁい
x,	ぉう
x.	ぇい
xp	ぅう
x;	ぁん
xq	ぉん
xj	ぇん
xk	ぅん
# xx	ぃん

xka	ヵ
xke	ヶ

xca	ヵ
xce	ヶ

xtu	っ
xtsu	っ

xya	ゃ
xyi	ぃ
xyu	ゅ
xye	ぇ
xyo	ょ
xy'	ゃい
xy,	ょう
xy.	ぇう
xyp	ょう
xy;	ゃん
xyq	ょん
xyj	ぇん
xyk	ゅん
xyx	ぃん

xha	ゃ
xhi	ぃ
xhu	ゅ
xhe	ぇ
xho	ょ
xh'	ゃい
xh,	ょう
xh.	ぇう
xhp	ょう
xh;	ゃん
xhq	ょん
xhj	ぇん
xhk	ゅん
xhx	ぃん

xwa	ゎ