za	ざ
zi	じ
zu	ず
ze	ぜ
zo	ぞ
z'	ざい
z,	ぞう
z.	ぜい
zp	ずう
z;	ざん
zq	ぞん
zj	ぜん
zk	ずん
zx	じん

zya	じゃ
zyi	じぃ
zyu	じゅ
zye	じぇ
zyo	じょ
zy'	じゃい
zy,	じょう
zy.	じぇい
zyp	じゅう
zy;	じゃん
zyq	じょん
zyj	じぇん
zyk	じゅん
zyx	じぃん

zha	じゃ
zhi	じぃ
zhu	じゅ
zhe	じぇ
zho	じょ
zh'	じゃい
zh,	じょう
zh.	じぇい
zhp	じゅう
zh;	じゃん
zhq	じょん
zhj	じぇん
zhk	じゅん
zhx	じぃん

zwa	ずぁ
zwi	ずぃ
zwu	ずぅ
zwe	ずぇ
zwo	ずぉ
zw'	ずぁい
zw,	ずぉう
zw.	ずぇい
zwp	ずぅう
zw;	ずぁん
zwq	ずぉん
zwj	ずぇん
zwk	ずゅん
zwx	ずん